ALK	BLCA;COAD;KIRP;LUAD;OV;READ;SKCM;THCA;TYCA;UCEC
BRAF	BLCA;LGG;LUSC;PRAD;READ;SKCM;THCA;TYCA
CLDN18	BRCA;LGG;STAD
EGFR	BLCA;GBM;HNSC;LGG
ERBB2	BLCA;BRCA;LIHC;LUSC;PRAD;READ;STAD;UCEC
ERG	BRCA;LAML;PRAD
ESR1	BRCA;LUSC;OV
ETV1	PRAD
ETV4	BRCA;LUAD;PRAD
FGFR1	BRCA;LUAD;LUSC;READ
FGFR2	BRCA;LUSC;OV;STAD;THCA;UCEC
FGFR3	BLCA;GBM;HNSC;KIRP;LGG;LUSC;OV;PRAD;STAD
FGR	LUSC;OV;SKCM
FLI1	---
LTK	THCA
MET	BRCA;KIRP;LGG;LIHC;LUAD;STAD;THCA;TYCA
NTRK1	GBM;SARC;THCA;TYCA
NTRK2	BRCA;HNSC;LGG;LUAD
NTRK3	BRCA;COAD;HNSC;LGG;READ;SKCM;THCA;TYCA
PAX8	THCA
PDGFRA	BRCA;GBM;LGG;LUAD
PIK3CA	BRCA;PRAD;UCEC
PKN1	BRCA;LIHC;LUSC;SKCM;UCEC
PRKCA	BRCA;KIRC;LUAD;LUSC;SKCM;STAD
PRKCB	GBM;LGG;LUAD;LUSC;PRAD
RAF1	BRCA;COAD;GBM;KIRC;KIRP;LUAD;PRAD;SKCM;THCA;TYCA
RET	BRCA;COAD;LUAD;THCA;TYCA
ROS1	GBM;LUAD
TFE3	BRCA;KIRC;KIRP
TFEB	GBM;OV
