ACO1	PANCAN;MEL
ACVR1B	PANCAN;BRCA;CRC
ACVR2B	PANCAN
ADNP	PANCAN;UCEC
AJUBA	PANCAN;HNSC
AKT1	PANCAN;BRCA;UCEC
ALK	PANCAN;NB
ALKBH6	PANCAN;UCEC
ALPK2	PANCAN;MEL
ANK3	PANCAN;UCEC;MEL
APC	PANCAN;CRC;LUAD
APOL2	PANCAN
ARHGAP35	PANCAN;UCEC;HNSC;KIRC;LUAD;LUSC
ARID1A	PANCAN;BLCA;BRCA;CRC;UCEC;ESO;KIRC;LUAD;LUSC
ARID2	PANCAN;CRC;HNSC;LUAD;MEL
ARID5B	PANCAN;UCEC
ASXL1	PANCAN;LAML;HNSC;LUSC
ASXL2	PANCAN
ATM	PANCAN;CLL;UCEC;KIRC;LUAD;PRAD
ATP5B	PANCAN
AXIN2	PANCAN;CRC
AZGP1	PANCAN;GBM
B2M	PANCAN;CRC;DLBCL;HNSC
BAP1	PANCAN;KIRC
BCLAF1	PANCAN;BLCA;CRC;MEL
BCOR	PANCAN;CRC;UCEC;GBM
BHMT2	PANCAN
BRAF	PANCAN;CRC;DLBCL;GBM;LUAD;MEL;MM
BRCA1	PANCAN;KIRC;OV
BRE	PANCAN
C3orf70	PANCAN;BLCA
CAP2	PANCAN;UCEC
CARD11	PANCAN;DLBCL
CASP8	PANCAN;BRCA;CRC;UCEC;HNSC
CBFB	PANCAN;BRCA
CCDC120	PANCAN;KIRC
CCDC6	PANCAN;UCEC
CCND1	PANCAN;UCEC
CD1D	PANCAN;GBM
CD70	PANCAN;CRC;DLBCL
CD79B	PANCAN;DLBCL
CDC27	PANCAN;CRC
CDH1	PANCAN;BRCA
CDK12	PANCAN;LUAD;OV
CDK4	PANCAN;MEL
CDKN1A	PANCAN;BLCA
CDKN1B	PANCAN;BRCA;CARC;UCEC;LUAD
CDKN2A	PANCAN;BLCA;ESO;HNSC;LUAD;LUSC;MEL
CEBPA	PANCAN;LAML
CEP76	PANCAN
CHD4	PANCAN;UCEC
CHD8	PANCAN;GBM
CNBD1	PANCAN;CRC
CNKSR1	PANCAN
COL5A1	PANCAN;UCEC;ESO;PRAD
COL5A3	PANCAN;KIRC
CREBBP	PANCAN;BLCA;DLBCL;OV
CTCF	PANCAN;BRCA;UCEC;HNSC
CTNNB1	PANCAN;CRC;UCEC;LUAD;MED;MEL
CUL4B	PANCAN;BRCA
CUX1	PANCAN;UCEC
DDX3X	PANCAN;CLL;MED
DDX5	PANCAN;BLCA;GBM
DIAPH1	PANCAN;UCEC
DIS3	PANCAN;MM
DNAH12	PANCAN
DNER	PANCAN;UCEC
DNMT3A	PANCAN;LAML
EGFR	PANCAN;GBM;KIRC;LUAD;LUSC
EIF2S2	PANCAN;UCEC
ELF3	PANCAN;BLCA;CRC
EP300	PANCAN;BRCA;UCEC;HNSC;LUSC
EPHA2	PANCAN;BLCA;HNSC
ERBB2	PANCAN;BRCA;CRC;UCEC;ESO;LUAD;OV
ERBB3	PANCAN;BLCA;BRCA;CRC;UCEC
ERCC2	PANCAN;BLCA
EZH1	PANCAN
EZH2	PANCAN;LAML;DLBCL
EZR	PANCAN;BLCA;GBM;MM
FAM166A	PANCAN
FAM46C	PANCAN;MM
FAT1	PANCAN;UCEC;HNSC;LUAD;LUSC
FBXW7	PANCAN;BLCA;CRC;UCEC;LUSC
FGFBP1	PANCAN
FGFR2	PANCAN;BRCA;UCEC
FGFR3	PANCAN;BLCA;KIRC;LUSC;MM
FLG	PANCAN;ESO
FLT3	PANCAN;LAML;UCEC
FOXA1	PANCAN;BRCA;PRAD
FOXQ1	PANCAN;BLCA
FRMD7	PANCAN;MEL
GATA3	PANCAN;BRCA
GNA13	PANCAN;DLBCL
GNB1	PANCAN
GNPTAB	PANCAN;BRCA;UCEC
GOT1	PANCAN;CRC
GPS2	PANCAN
GUSB	PANCAN;KIRC
HIST1H1E	PANCAN;CLL
HIST1H3B	PANCAN;BRCA;DLBCL
HIST1H4E	PANCAN
HLA-A	PANCAN;DLBCL;HNSC;LUSC
HLA-B	PANCAN;HNSC
HRAS	PANCAN;BLCA;HNSC;LUSC
HSP90AB1	PANCAN
IDH1	PANCAN;LAML;CLL;GBM;MM
IDH2	PANCAN;LAML;CRC
IL7R	PANCAN;ESO
ING1	PANCAN;UCEC
INPPL1	PANCAN;UCEC
INTS12	PANCAN;MM
IPO7	PANCAN;HNSC
IRF4	PANCAN;MM
IRF6	PANCAN
ITGB7	PANCAN
ITPKB	PANCAN;DLBCL
JAK1	CLL
KDM5C	PANCAN;KIRC
KDM6A	PANCAN;LAML;BLCA;HNSC
KEAP1	PANCAN;LUAD;LUSC
KEL	PANCAN;GBM
KIT	PANCAN;LAML;MEL
KLHL8	PANCAN;UCEC
KRAS	PANCAN;LAML;BRCA;CRC;DLBCL;UCEC;ESO;LUAD;MM;OV
LCTL	PANCAN;MEL
MAP2K1	PANCAN;DLBCL;LUAD
MAP2K4	PANCAN;BRCA;CRC
MAP3K1	PANCAN;BRCA;GBM
MAP4K3	PANCAN;HNSC
MBD1	PANCAN
MED12	PANCAN;CLL;PRAD
MED23	PANCAN;BRCA
MET	PANCAN;LUAD
MGA	PANCAN;BLCA;UCEC
MICALCL	PANCAN;UCEC
MLL	PANCAN;BLCA;BRCA
MLL2	PANCAN;BLCA;DLBCL;HNSC;LUSC
MLL3	PANCAN;BLCA;BRCA;HNSC;LUAD
MLL4	PANCAN;UCEC
MORC4	PANCAN;UCEC
MPO	PANCAN;KIRC
MTOR	PANCAN;UCEC;KIRC
MUC17	PANCAN;GBM
MXRA5	PANCAN;LAML;MEL
MYB	PANCAN;BRCA
MYCN	PANCAN;UCEC
MYD88	PANCAN;CLL;DLBCL
MYOCD	PANCAN;MEL
NBPF1	PANCAN;LUAD
NCOR1	PANCAN;BRCA;HNSC;MEL
NF1	PANCAN;GBM;LUAD;LUSC;OV
NFE2L2	PANCAN;BLCA;UCEC;HNSC;LUSC
NOTCH1	PANCAN;DLBCL;HNSC;LUSC
NPM1	PANCAN;LAML
NRAS	PANCAN;LAML;CLL;CRC;UCEC;LUAD;MEL;MM;OV
NSD1	PANCAN;HNSC;LUSC
NTN4	PANCAN;CRC
NUP210L	PANCAN;GBM
ODAM	PANCAN
OMA1	PANCAN
OR4A16	PANCAN;MEL
OR52N1	PANCAN;MEL
OTUD7A	PANCAN;HNSC
PAPD5	PANCAN;LAML
PBRM1	PANCAN;UCEC;HNSC;KIRC
PCBP1	PANCAN;CRC
PDAP1	PANCAN
PDCD2L	PANCAN
PDSS2	PANCAN;LAML
PHF6	PANCAN;LAML;BLCA
PIK3CA	PANCAN;BLCA;BRCA;CRC;UCEC;ESO;GBM;HNSC;KIRC;LUAD;LUSC;MEL
PIK3R1	PANCAN;BRCA;UCEC;ESO;GBM
PLCG2	PANCAN
POLE	PANCAN;UCEC
POU2AF1	PANCAN;DLBCL
POU2F2	PANCAN;DLBCL
PPM1D	PANCAN;UCEC
PPP2R1A	PANCAN;UCEC
PPP6C	PANCAN;MEL
PRDM1	PANCAN;MM
PTEN	PANCAN;BRCA;CRC;DLBCL;UCEC;GBM;HNSC;KIRC;LUSC;MEL
PTPN11	PANCAN;LAML;GBM;MM
QKI	PANCAN;GBM
RAB40A	PANCAN;BRCA
RAC1	PANCAN;HNSC;MEL
RAD21	PANCAN;LAML
RASA1	PANCAN;UCEC;HNSC;LUSC
RB1	PANCAN;BLCA;BRCA;UCEC;GBM;HNSC;LUAD;LUSC;OV
RBM10	PANCAN;CRC;LUAD
RHEB	PANCAN;KIRC
RHOA	PANCAN;BLCA;HNSC
RIT1	PANCAN;LUAD
RPL5	PANCAN;GBM
RPS15	PANCAN;CLL
RPS2	PANCAN;CLL
RSBN1L	PANCAN;UCEC
RUNX1	PANCAN;LAML;BRCA
RXRA	PANCAN;BLCA;MEL
SACS	PANCAN;UCEC;ESO
SELP	PANCAN;UCEC
SEPT12	PANCAN
SERPINB13	PANCAN;LUSC
SETD2	PANCAN;BLCA;GBM;KIRC
SETDB1	PANCAN;CLL;ESO
SF3B1	PANCAN;BRCA;CLL
SFRS2	PANCAN;LAML
SGK1	PANCAN;UCEC
SIRT4	PANCAN;CRC
SLC1A3	PANCAN;UCEC
SLC26A3	PANCAN;GBM
SLC44A3	PANCAN;UCEC
SLC4A5	PANCAN;LUAD
SMAD2	PANCAN;CRC
SMAD4	PANCAN;CRC;ESO;HNSC;LUAD
SMARCA4	PANCAN;ESO;LUAD
SMARCB1	PANCAN;ESO;OV;RHAB
SMC1A	PANCAN;LAML;GBM
SMC3	PANCAN;LAML
SNX25	PANCAN;BLCA
SOS1	PANCAN;UCEC
SOX17	PANCAN;UCEC
SPEN	PANCAN;BRCA;CLL
SPOP	PANCAN;UCEC;PRAD
STAG2	PANCAN;LAML;BLCA;BRCA;GBM
STK11	PANCAN;LUAD;LUSC
STK19	PANCAN;MEL
STX2	PANCAN;LUAD
TAP1	PANCAN;UCEC
TBC1D12	PANCAN;BLCA
TBL1XR1	PANCAN;BRCA;UCEC
TBX3	PANCAN;BRCA
TCEB1	PANCAN;KIRC
TCF7L2	PANCAN;CRC
TCP11L2	PANCAN;UCEC
TDRD10	PANCAN;UCEC
TET2	PANCAN;LAML
TGFBR2	PANCAN;BLCA;HNSC
TIMM17A	PANCAN
TNF	PANCAN;DLBCL
TNFRSF14	PANCAN;DLBCL
TP53	PANCAN;LAML;BLCA;BRCA;CLL;CRC;DLBCL;UCEC;ESO;GBM;HNSC;KIRC;LUAD;LUSC;MED;MEL;MM;OV;PRAD
TP53BP1	PANCAN;UCEC
TPX2	PANCAN;UCEC
TRAF3	PANCAN;CRC;MM
TRIM23	PANCAN;CRC
TSC1	PANCAN;BLCA
TTLL9	PANCAN;UCEC
TXNDC8	PANCAN;UCEC
U2AF1	PANCAN;LAML;LUAD
VHL	PANCAN;KIRC
WASF3	PANCAN;MEL
WT1	PANCAN;LAML
XIRP2	PANCAN;MEL
XPO1	PANCAN;CLL
ZFHX3	PANCAN;UCEC
ZNF180	PANCAN
ZNF471	PANCAN;DLBCL;UCEC
ZNF483	PANCAN
ZNF620	PANCAN;UCEC
ZNF750	PANCAN;HNSC;MEL
ZRANB3	PANCAN;UCEC
